NO ./test.xpm
SO ./test.xpm
WE ./test.xpm
EA ./test.xpm


F 	0   ,   120 , 	 +250 

C					225	,   30	,  0

1111111111111111111111111111111111111111111111111111111111111111111111111111
1111111111111111111111111111111 1111111111 111111111111111111111111111111111
11111111111111111111111111111111 11111111 1111111111111111111111111111111111
1111111111111111111111111111111  10000001  111111111111111111111111111111111
111111111111111111111111111111111 110011 11111111111111111111111111111111111
111111111111111111111111111111111 100001 11111111111111111111111111111111111
111111111111111111111111111 11 101000000101 11 11111111111111111111111111111
11111000000111111111111111111 11000000000011 1111111111111111110000001111111
111110000001111111111111111111 101000000101 11111111111111111110000001111111
111110011001111111111111111111111 100001 11111111111111111111110011001111111
11111001100111111111111111111111 10000001 1111111111111111111110011001111111
1110100110010111111111111111111 1000000001 111111111111111111010011001011111
100000000000000111111111111111 100000000001 11111111111111100000000000000111
100000000000000011111111111111 100000000001 11111111111111000000000000000011
1100100110010011111111111111111000000000000111111111111111110110000001101111
111010011001011111111111111 100000000000000001 11111111111111010011001011111
11 1000110001 111111111111 10001000000000010001 111111111111 1000110001 1111
111 10011001 111111111111010001 1000000001 100011111111111111 10011001    11
111 10011001 111111111110000001 1000000001 100000011111111111 10011001 11111
1   10011001    111111100000001 1000000001 100000001111111    10011001     1
111 10011001 11111111100000001 100000000001 10000000111111111 10011001 111111
111 10011001 11111111000000001 100000000001 10000000011111111 10011001 1111111
111 10011001 1111110000000001 10000000000001 1000000001111111 10011001 1111111
1111100000011111000000000111 1100000000000011 1110000000001111100000011111111
111N0000000000000000000001  100000000000000001  1000000000000000000000111111
1111111111111111111111111  10000000000000000001  11111111111111111111111111
111111111111111111111111  1000000000000000000001  1111111111111111111111111
111111111111111111111111  1000000000000000000001  11111111111111111111111111
1111111111111111111111111  10000000000000000001  1111111111111111111111111
100000000000000000000000111 100000000000000001 11100000000000000000000001
111111111111111111111111111  1000000000000001  11111111111111111111111111
1111111111111111111111111111  11111111111111  1111111111111111111111111111
11111111111111111111111111                       1111111111111111111111111
1111111111111111111111111  111111111111111111111  1111111111111111111111111
111111111111111111111111  1                     1  1111111111111111111111111
111111111111111111111111  11111111111111111111111  1111111111111111111111111
111111111111111111111111                           111111111111111111111111
111111111111111111111111111111111111111111111111111111111111111111111111111
