NO ./path_to_the_North_texture
SO ./path_to_the_south_texture
WE ./path_to_the_west_texture
EA ./path_to_the_east_texture


F ,		0   ,   120 , 	 +250  ,,,,,

C			,		225	,   30	,  0	,,,

1111111111111111111111111111111111111111111111111111111111111111111111
10000000000000000000100000000000000000000000000000000000000000000000001111111111
10000000011000000000100000000000000000000000000000000000000000000000000000000001
10000000110000000001000000000000000000000000100000000000000000000000000000000001
11111111111011111111100000000000001000000000010000000000000000000000000000000001
10000000000000000000100000000000001000000000010000000000000000000000000000000001
10000000000000000000100000000000001000000000010000000000000000000000000000000001
10000000000000000000100000000000001000000000010000000000000000000000000000000001
10000000000000000000100000000000001000000000010000000000000000000000000000000001
10000000000000000000100000000000001000000000010000000000000000000000000000000001
10000000000000000000100000000000001000000000010000000000000000000000000000000001
10000000000000000000100000000000001000000000000000000000000000000000000000000001
10000000000000000000111111111111111000000000000000000000000000000000000000000001
10000000000000000000000000000000000000000000000000000000000000000000000000000001
10000000000000000000000000000000000000000000000000000000000010000000000000000001
10000000000000000000000000000000000000000000000000000000000000000000000000000001
10000000000000000000000000000000000000000000000000000000000000000000000000000001
10000000000000000000000000000000000000000000000000000000000100000000000000000001
10000000000000000000000000000000000000000000000000000000000000000000000000000001
10000000000000000000000000000000000000000000000001000000000000000000000000000001
10000000000000011111111110011111111100000000000000000000000000000000000000000001
10000000000000010000000000000000000100000000000000000100000000000000000000000001
10000000000000010100000111110000000100000000000000000000000000000000000000000001
100000000000000100000001   10001000100000000000000000000000000000000000000000001
10000000000000010100001   10000000100000000000000000100000000000000000000000001
10000000000000010000000111110000000100000000000000001110000000000000000000000001
10000000000000010000000000100000000100000000000000000100000000000000000000000001
10000000000000011111111111111111111100000000000000000000000000000000000000000001
10000000010111110000000000000000000000000000000000000000000000000000000000000001
10000000010000000000000000000000000000000000000000000000000000000000000000000001
10000000010000000000000000000000000000000000000000000000000000000000000000000001
10000000010000000000000000000000000000000000000000000000000000000000000000000001
10000000010000000000000000000000000000000000000000000000000000000000000000000001
10000000010000000000000000000000000000000000000000000000000000000000000000000001
10000000010000000000000000000000000000000000000000000000000000000000000000000001
10000000010000000000000000000000000000000000000000000000000000000000000000000001
11111111111111111111111111111111111111111111111111111111111111111111011111111111
10000000000000000000000000000000000000000000000000000000000000000000001111111111
1111111111111111111111111111111111111111111111111111111111111111111101
10000000000000000000100000000000000000000000000000000000000000000000001111111111
10000000011000000000100000000000000000000000000000000000000000000000000000000001
10000000110000000001000000000000000000000000100000000000000000000000000000000001
11111111111011111111100000000000001000000000010000000000000000000000000000000001
10000000000000000000100000000000001000000000010000000000000000000000000000000001
10000000000000000000100000000000001000000000010000000000000000000000000000000001
10000000000000000000100000000000001000000000010000000000000000000000000000000001
10000000000000000000100000000000001000000000010000000000000000000000000000000001
10000000000000000000100000000000001000000000010000000000000000000000000000000001
10000000000000000000100000000000001000000000010000000000000000000000000000000001
10000000000000000000100000000000001000000000000000000000000000000000000000000001
10000000000000000000111111111111111000000000000000000000000000000000000000000001
10000000000000000000000000000000000000000000000000000000000000000000000000000001
10000000000000000000000000000000000000000000000000000000000010000000000000000001
10000000000000000000000000000000000000000000000000000000000000000000000000000001
10000000000000000000000000000000000000000000000000000000000000000000000000000001
10000000000000000000000000000000000000000000000000000000000100000000000000000001
10000000000000000000000000000000000000000000000000000000000000000000000000000001
10000000000000000000000000000000000000000000000001000000000000000000000000000001
10000000000000011111111110011111111100000000000000000000000000000000000000000001
10000000000000010000000000000000000100000000000000000100000000000000000000000001
10000000000000010100000101110000000100000000000000000000000000000000000000000001
100000000000000100000001   10001000100000000000000000000000000000000000000000001                  1
1000000000000001010000N1   10000000100000000000000000100000000000000000000000001
10000000000000010000000111110000000100000000000000001110000000000000000000000001
10000000000000010000000000100000000100000000000000000100000000000000000000000001
10000000000000011111111111111111111100000000000000000000000000000000000000000001
100000000101111100000000000000000000000000000000000000000000000000000000000000001        1
10000000010000000000000000000000000000000000000000000000000000000000000000000001
10000000010000000000000000000000000000000000000000000000000000000000000000000001
10000000010000000000000000000000000000000000000000000000000000000000000000000001
10000000010000000000000000000000000000000000000000000000000000000000000000000001
10000000010000000000000000000000000000000000000000000000000000000000000000000001
10000000010000000000000000000000000000000000000000000000000000000000000000000001
10000000010000000000000000000000000000000000000000000000000000000000000000000001
11111111111111111111111111111111111111111111111111111111111111111111111111111111

111111111111111111111111
1000000000110000000000001
1011000001110000000000001
100100000000000000000000 1111111111111
1111111110110000011100000            1
10000000001100000111011111111111111111
11110111111111011100000010001
11110111111111011101010010001
110000001101010111000000010001
10000000000000001100000010001
10000000000000001101010010001
1100000111010101111101111000111
11110111 1110101 101111010001
11111111 1111111 111111111111



