NO ./path_to_the_North_texture.xpm
SO ./path_to_the_south_texture
WE ./path_to_the_west_texture
EA ./path_to_the_east_texture


F ,		0   ,   120 , 	 +250  ,,,,,

C			,		225	,   30	,  0	,,,

1111111111111111111111111
10000000001100000000000011
1011000001110000000000001 1
100100000000000000000000111111111
111111111011000001110000000000001
100000000011000001110111111111111
11110111111111011100000010001
11110111111111011101010010001
11000000110101011100000010001
10000000000000001100000010001
10000000000000001101010010001
11000001110101011111011110N0111
11110111 1110101 101111010000111
11111111 1111111 111111111111

11111111
1      1
11111111
