NO ../cub3d/test.xpm
SO ../cub3d/test.xpm
WE ../cub3d/test.xpm
EA ../cub3d/test.xpm

F 	0   ,   120 , 	 +250 

C					225	,   30	,  0

11111      1111111111111     111111111111
    11111110000000000001111110000000000001
    11111000000000000000000000000000111101
    10000011111111111111000001111111111101
11111N11111            11111111111     1001
111111  1  1          1  1  111111      101
111111 101 1          1 101 111111      101
111111  1  1          1  1  111111      101
100000111111          111111000001      101
1111111111111111111111111111111111      101
               101                 1    101 1
             1100011             1101111101101
           11000000011          1  1  111011001
         110000000000011       1       110100001
        10000000000000001     1         110000001
        11111110000000011111111111111111111111111
              100000000000000000111111111
			   1111111110000000000000000011111
			            11111111111111111
						         111111111111111
