NO ../cub3d/test.xpm
SO ../cub3d/test.xpm
WE ../cub3d/test.xpm
EA ../cub3d/test.xpm


F 	0   ,   120 , 	 +250 

C					225	,   30	,  0

111111111111111111111111111111111111111111111111111
111111111111111100011111111111111111111111111111111
1111111000000000010000000100001             1011111
11111110000000001 11001001001001           10011111
1111111000011011 1 11010010010001         100011111
111111100001 1   11110100100100001       1000011111
11111000001     1000001001001000001     10000011111
11111N000001   100000010010010000001   100000011111
1111100000001 10000000100100100000001 1000000011111
111111111111111100011110000011111111111111111111111
111111111111111111111111101111111111111111111111111
111111111000111111111111000111111111111111111111111
111111110000011111111110000011111111111111111111111
111111100000001111111100000001111111111111111111111
111111110000011111111000000000111111111111111111111
111111111000111111110100000001011111111111111111111
111111111111111111100010000010001111111111111111111
111111111111111111000001000100000111111111111111111
111111111111111110000000101000000011111111111111111
111111111111111111111111111111111111111111111111111
