NO ../cub3d/textures/awesome.xpm
SO ../cub3d/textures/beige_stone.xpm
WE ../cub3d/textures/village_wall.xpm
EA ../cub3d/textures/village.xpm

F 	190, 165, 130     

C		150, 188, 227  


111111
100101
101001
1100N1
111111