111111111111111111111111111111111111111111111111111111111111111111111111111111111111111111111111
100000001     11111111111111111     1111111111111111111111111111111111111111111111111111111111111111111111
1111000001  111111111111111111111  11111111111111111111111111111111111111111111111111111111111111111
11111111111  1111111111111111111  111111111111111111111111111111111111111111111111111111111111111111
111111111111  11111111111111111  1111111111111111111111111111111111111111111111111111111111111111111
1111111111111                   11111111111111111111111111111111111111111111111111111111111111111111111
111111111111111111111111111111111111111111111111111111111111111111111111111111111111111111111111
1111111111111                   11111111111111111111111111111111111111111111111111111111111111111111111
111111111111  11111111111111111  1111111111111111111111111111111111111111111111111111111111111111111
11111111111  1111111111111111111  111111111111111111111111111111111111111111111111111111111111111111
1111000001  111111111111111111111  11111111111111111111111111111111111111111111111111111111111111111
100000001     11111111111111111     1111111111111111111111111111111111111111111111111111111111111111111111
111111111111111111111111111111111111111111111111111111111111111111111111111111111111111111111111
111111111111111111111N111111111111111111111111111111111111111111111111111111111111111111111111
111111111111111111111111111111111111111111111111111111111111111111111111111111111111111111111111
111111111111111111111111111111111111111111111111111111111111111111111111111111111111111111111111
111111111111111111111111111111111111111111111111111111111111111111111111111111111111111111111111
